42
30
12 12 12 12 12 12 12 12 12 12 12 12 12 12 12 12 12 12 12 12 12 12 12 12 12 12 12 12 12 12 12 12 12 12 12 12 12 12 12 12 12 12 
12 0 0 0 0 0 0 0 0 0 0 0 11 12 12 12 12 12 12 12 12 12 12 12 12 12 12 12 12 32 0 0 0 0 0 0 0 0 0 0 0 12 
12 0 0 0 0 0 0 0 0 0 0 0 11 12 12 12 12 12 12 12 12 12 12 12 12 12 12 12 12 32 0 0 0 0 0 0 0 0 0 0 0 12 
12 0 0 0 0 0 0 0 0 0 0 0 21 22 22 22 22 22 22 22 22 22 22 22 22 22 22 22 22 42 0 0 0 0 0 0 0 0 0 0 0 12 
12 0 0 0 0 0 0 0 0 0 0 0 0 47 0 0 0 0 0 108 108 108 108 0 0 0 0 0 0 0 0 0 0 0 0 0 0 108 108 108 0 12 
12 0 0 0 0 0 0 0 0 0 0 0 0 57 0 0 0 108 108 108 0 0 108 108 108 0 0 0 0 0 0 0 0 0 0 0 0 108 108 108 0 12 
12 30 30 30 0 0 0 0 0 0 0 0 0 67 0 0 0 0 0 0 0 0 0 0 0 0 0 0 0 0 0 0 0 0 0 0 0 108 108 108 0 12 
12 0 0 0 0 0 0 0 0 0 0 0 30 10 10 10 10 10 10 10 10 10 10 10 10 10 10 10 10 10 10 10 0 0 0 0 0 0 0 0 0 12 
12 0 0 0 0 0 0 0 0 0 0 0 0 10 10 10 10 10 10 10 10 10 10 10 10 10 10 10 10 0 0 86 0 0 0 0 0 0 0 0 0 12 
12 0 0 0 0 0 0 0 0 0 0 0 0 10 10 10 10 10 10 10 10 10 10 10 10 10 10 10 10 0 0 96 0 0 0 0 0 0 0 0 0 12 
12 0 0 0 30 30 0 0 0 0 0 0 0 10 10 10 10 10 10 10 10 10 10 10 10 10 10 10 10 0 0 106 0 0 0 0 0 0 0 0 0 12 
12 0 0 0 0 0 0 0 0 0 0 30 30 10 10 10 10 10 10 10 10 10 10 10 10 10 10 10 10 30 30 30 0 0 0 0 0 0 0 0 0 12 
12 0 0 0 0 0 0 0 0 0 0 0 0 10 10 10 10 10 10 10 10 10 10 10 10 10 10 10 10 0 0 0 0 0 0 0 0 0 0 0 0 12 
12 0 0 0 0 0 0 0 0 0 0 0 0 10 10 10 10 10 10 10 10 10 10 10 10 10 10 10 10 0 0 0 0 0 0 0 0 0 0 0 0 12 
12 0 0 0 0 0 0 0 0 30 30 0 0 10 10 10 10 10 10 10 10 10 10 10 10 10 10 10 10 0 0 30 30 30 0 0 0 0 0 0 0 12 
12 0 0 0 58 0 0 0 0 0 0 0 0 10 10 10 10 10 10 10 10 10 10 10 10 10 10 10 10 0 0 0 0 0 0 0 0 0 0 58 0 12 
12 0 0 0 30 0 0 0 0 0 0 0 0 10 10 10 10 10 10 10 10 10 10 10 10 10 10 10 10 0 0 0 0 0 0 0 0 0 30 30 0 12 
12 0 0 0 0 0 0 0 0 0 0 0 0 10 10 10 10 10 10 10 10 10 10 10 10 10 10 10 10 0 0 0 0 30 30 0 0 0 0 0 0 12 
12 0 0 0 0 0 0 0 0 0 0 30 30 10 10 10 10 10 10 10 10 10 10 10 10 10 10 10 10 0 0 0 0 0 0 0 0 0 0 0 0 12 
12 0 0 0 0 0 0 0 0 0 0 0 0 10 10 10 10 10 10 10 10 10 10 10 10 10 10 10 10 30 30 0 0 0 0 0 0 0 0 0 0 12 
12 0 0 0 0 0 0 0 0 0 0 0 0 47 87 7 108 108 108 108 0 0 108 108 108 108 6 86 46 0 0 0 0 0 0 30 30 0 0 0 0 12 
12 0 0 0 0 0 0 0 0 0 0 0 0 57 97 17 108 108 108 108 0 0 108 108 108 108 16 96 56 0 0 0 0 0 0 0 0 0 0 0 0 12 
12 0 0 0 0 0 0 0 58 0 0 0 0 67 107 27 108 108 108 108 28 28 108 108 108 108 26 106 66 0 0 0 0 0 0 0 0 0 0 0 0 12 
12 0 0 1 31 0 0 1 31 0 0 1 2 2 2 2 2 2 2 2 2 2 2 2 2 2 2 2 2 2 31 0 0 1 31 0 0 1 31 0 0 12 
12 0 0 11 32 0 0 11 32 0 0 11 12 12 12 12 12 12 12 12 12 12 12 12 12 12 12 12 12 12 32 0 0 11 32 0 0 11 32 0 0 12 
12 0 0 11 32 0 0 11 32 0 0 11 12 12 12 12 12 12 12 12 12 12 12 12 12 12 12 12 12 12 32 0 0 11 32 0 0 11 32 0 0 12 
12 0 0 11 32 0 0 11 32 0 0 11 12 12 12 12 12 12 12 12 12 12 12 12 12 12 12 12 12 12 32 0 0 11 32 0 0 11 32 0 0 12 
12 0 0 11 32 0 8 11 32 0 18 11 12 12 12 12 12 12 12 12 12 12 12 12 12 12 12 12 12 12 32 0 0 11 32 0 0 11 32 68 68 12 
12 0 0 11 32 0 0 11 32 0 0 11 12 12 12 12 12 12 12 12 12 12 12 12 12 12 12 12 12 12 32 0 0 11 32 0 0 11 32 0 0 12 
12 12 12 12 12 12 12 12 12 12 12 12 12 12 12 12 12 12 12 12 12 12 12 12 12 12 12 12 12 12 12 12 12 12 12 12 12 12 12 12 12 12 
