48
60
10 10 10 10 10 10 10 10 10 10 10 10 10 10 10 10 10 10 10 10 10 10 10 10 10 10 10 10 10 10 10 10 10 10 10 12 12 12 12 12 12 12 12 12 12 12 12 12 32 
10 10 10 10 10 10 10 10 10 10 10 10 10 10 10 10 10 10 10 10 10 10 10 10 10 10 10 10 10 10 10 10 10 10 10 12 12 12 12 12 12 12 12 12 12 12 12 12 32 
10 10 10 10 10 10 10 10 10 10 10 10 10 10 10 10 10 10 10 10 10 10 10 10 10 10 10 10 10 10 10 10 10 10 10 12 12 12 12 12 12 12 12 12 12 12 12 12 32 
10 10 10 10 10 10 10 10 10 10 10 10 10 10 10 10 10 10 10 10 10 10 10 10 10 10 10 10 10 10 10 10 10 10 10 12 12 12 12 12 12 12 12 12 12 12 12 12 32 
10 10 10 10 10 10 10 10 10 10 10 10 10 10 10 10 10 10 10 10 10 10 10 10 10 10 10 10 10 10 10 10 10 10 10 12 12 12 12 12 12 12 12 12 12 12 12 12 32 
10 0 0 0 0 0 0 0 0 0 0 0 0 0 0 0 10 10 10 10 10 10 10 10 10 10 10 10 10 10 10 10 10 10 10 12 12 12 12 12 12 12 12 12 12 12 12 12 32 
10 0 0 0 0 0 0 0 0 0 0 0 0 0 0 0 0 10 10 10 10 10 10 10 10 10 10 10 10 10 10 10 10 10 10 12 12 12 12 12 12 12 12 12 12 12 12 12 32 
10 0 0 0 0 0 0 0 0 0 0 0 0 0 0 0 0 0 10 10 10 10 10 10 10 10 10 10 10 10 10 10 10 10 10 12 12 12 12 12 12 12 12 12 12 12 12 12 32 
10 28 0 0 0 0 0 0 0 0 0 0 0 0 0 0 0 0 0 10 10 10 10 10 10 10 10 10 10 10 10 10 10 10 10 12 12 12 12 12 12 12 12 12 12 12 12 12 32 
10 10 8 10 10 10 10 10 10 10 10 10 0 0 0 0 0 0 0 0 10 10 10 10 10 10 10 10 10 10 10 10 10 10 10 12 12 12 12 12 12 12 12 12 12 12 12 12 32 
10 10 10 10 10 10 10 10 10 10 10 10 10 0 0 0 0 0 0 0 0 10 10 10 10 10 10 10 10 10 10 10 10 10 10 12 12 12 12 12 12 12 12 12 12 12 12 12 32 
10 10 10 10 10 10 10 10 10 10 10 10 10 10 0 0 0 0 0 0 0 0 0 0 0 0 0 0 0 0 0 0 0 0 11 12 12 12 12 12 12 12 12 12 12 12 12 12 32 
10 10 10 10 10 10 10 10 10 10 10 10 10 10 10 0 0 0 0 0 0 0 0 0 0 0 0 0 0 0 0 0 0 0 21 22 22 22 22 22 22 22 22 22 22 22 40 12 32 
10 10 10 10 10 10 10 10 10 10 10 10 10 10 10 10 0 0 0 0 0 0 0 0 0 0 0 0 0 0 0 0 0 0 0 0 0 0 0 0 0 0 0 0 0 0 11 12 32 
10 10 10 10 10 10 10 10 10 10 10 10 10 10 10 10 10 0 0 0 0 0 0 0 0 0 0 0 0 0 0 0 0 0 0 0 0 0 0 0 0 0 0 0 0 0 11 12 32 
12 12 12 12 12 12 12 12 12 12 12 12 12 12 12 12 12 2 2 2 2 2 2 31 0 0 0 0 0 0 0 0 0 0 0 0 0 0 0 0 0 0 0 0 0 0 11 12 32 
41 22 22 22 22 22 22 22 22 22 22 22 22 22 22 22 22 22 22 22 22 22 40 32 0 0 0 0 0 0 0 0 0 0 0 0 0 0 0 0 0 0 0 0 0 0 11 12 32 
32 0 0 0 0 0 0 0 0 0 0 0 0 0 0 0 0 0 0 0 0 0 11 32 0 0 0 0 1 2 2 2 31 0 30 0 0 0 0 0 1 31 0 0 0 0 11 12 32 
32 0 0 0 0 0 0 0 0 0 0 0 0 0 0 0 0 0 0 0 0 0 11 32 0 0 0 30 11 12 12 12 32 0 0 0 0 0 30 0 11 32 0 0 0 0 11 12 32 
32 0 0 0 0 0 0 0 0 0 28 0 108 0 0 0 0 0 108 108 0 0 11 32 0 0 0 0 11 12 12 12 32 0 0 30 0 0 0 0 11 32 0 0 0 0 11 12 32 
32 0 0 0 0 0 0 0 10 10 10 10 10 0 0 0 0 0 0 108 108 0 11 32 0 0 0 30 11 12 12 12 32 0 0 0 0 0 0 0 11 32 0 0 0 0 11 12 32 
32 0 0 0 0 0 0 0 0 47 0 46 0 0 0 0 0 0 0 0 0 108 11 32 0 0 0 0 11 12 12 12 32 0 0 0 0 0 30 0 11 32 0 0 0 0 11 12 32 
32 0 0 0 0 0 0 0 0 57 0 56 0 0 0 0 0 0 0 0 0 0 11 32 0 0 0 30 11 12 12 12 32 0 0 0 0 0 0 0 11 32 0 0 0 0 11 12 32 
32 0 0 0 0 0 108 0 0 67 0 66 0 0 108 0 0 0 0 0 0 0 11 32 0 0 0 0 11 12 12 12 32 0 0 0 30 0 0 0 11 32 0 0 0 0 11 12 32 
32 0 0 0 0 10 10 10 10 10 10 10 10 10 10 10  0 0 0 0 0 0 11 32 0 0 0 30 11 12 12 12 32 0 0 0 0 0 0 0 11 32 0 0 0 0 11 12 32 
32 0 0 0 0 0 0 0 0 0 0 0 0 0 0 0 0 0 0 0 0 0 11 32 0 0 0 0 11 12 12 12 32 0 0 0 0 0 0 0 11 32 0 0 0 0 11 12 32 
32 0 0 0 0 0 0 0 0 0 0 0 0 0 0 0 0 0 0 0 0 0 11 32 0 0 0 30 11 12 12 12 32 0 0 0 0 0 30 0 11 32 0 0 0 0 11 12 32 
32 0 0 0 0 0 0 0 0 0 0 0 0 0 0 0 0 0 0 0 0 0 46 0 0 0 0 0 11 12 12 12 32 0 0 0 28 0 0 0 11 32 0 0 0 0 11 12 32 
32 0 0 0 0 0 0 0 0 0 0 0 0 0 0 0 0 0 0 0 0 0 56 0 0 0 0 30 11 12 12 12 51 29 29 29 2 29 29 29 50 32 0 0 0 0 11 12 32 
32 0 0 0 0 0 0 0 0 0 0 0 0 0 0 0 0 0 0 0 0 0 66 0 0 0 0 0 11 12 12 41 22 22 22 22 22 22 22 22 40 32 0 0 0 0 11 12 32 
32 0 0 0 0 0 0 0 0 0 0 0 0 0 0 0 0 0 0 0 0 0 1 2 2 2 2 2 12 12 12 32 0 0 0 0 0 0 0 0 11 32 0 0 0 0 11 12 32 
32 0 0 0 0 0 0 0 0 0 0 0 0 0 0 0 0 0 0 0 0 0 21 22 22 22 22 22 22 22 40 32 0 0 0 0 0 0 0 0 11 32 0 0 0 0 11 12 32 
32 0 0 0 0 0 0 0 0 0 0 0 0 0 0 0 0 0 0 0 0 0 0 0 0 0 0 0 0 0 11 32 28 0 0 0 0 0 0 0 11 32 0 0 0 0 11 12 32 
32 0 0 0 0 0 0 0 0 0 0 0 0 0 0 0 0 0 0 0 0 0 0 0 0 0 0 0 0 0 11 12 2 2 2 2 31 0 0 0 11 32 0 0 0 0 11 12 32 
32 0 0 0 0 0 0 0 0 0 0 0 0 0 0 0 0 0 0 108 0 0 108 0 0 0 0 0 0 0 21 22 22 22 22 22 42 0 0 0 21 42 0 0 0 0 11 12 32 
32 0 58 0 28 0 0 0 0 0 0 0 0 0 0 0 1 2 2 0 2 31 0 30 0 0 0 0 0 0 0 0 0 0 0 0 0 0 0 30 0 0 0 0 0 58 11 12 32 
12 2 2 2 2 2 8 31 0 108 0 0 0 0 0 0 11 12 12 0 12 32 0 0 0 0 108 0 0 0 0 0 0 0 0 0 0 0 0 0 0 0 0 0 0 0 11 12 32 
41 22 22 22 22 22 22 42 0 0 0 0 0 0 0 0 11 12 12 0 12 32 0 0 0 0 30 0 0 0 0 0 0 0 0 0 0 0 0 0 0 0 0 0 0 0 11 12 32 
32 0 0 0 0 0 0 0 0 0 0 0 0 0 0 0 11 12 12 0 12 32 0 0 0 0 0 0 0 0 0 0 0 0 0 1 2 2 2 2 2 31 0 1 2 2 12 12 32 
32 0 0 0 0 0 0 0 0 0 0 0 0 0 0 0 11 12 12 18 12 32 0 0 0 0 0 0 0 30 0 0 0 0 30 21 22 22 22 22 22 22 22 22 22 22 22 22 42 
32 0 0 0 0 0 0 0 0 0 0 0 0 108 0 0 11 12 12 12 12 32 0 0 0 0 0 0 0 0 0 0 0 0 0 0 0 87 0 0 0 0 0 0 0 0 0 0 0 
32 0 0 0 0 0 0 0 0 0 0 0 0 0 0 0 11 12 12 12 12 32 0 0 0 0 0 0 0 0 0 0 30 0 0 0 0 97 0 0 0 0 0 0 0 0 0 0 0 
32 0 0 0 0 0 0 0 0 0 0 0 108 0 0 0 11 12 12 12 12 32 0 0 0 0 0 0 0 0 0 0 0 0 0 0 0 97 0 0 0 0 0 0 0 0 0 0 0 
32 0 0 0 0 0 0 0 0 0 0 0 0 0 0 0 11 12 12 12 12 32 0 0 0 0 0 0 0 0 30 0 0 108 108 0 0 107 0 0 0 0 0 0 0 0 0 0 0 
32 0 0 0 0 0 0 0 0 0 0 0 0 0 0 0 11 12 12 12 12 32 0 0 0 0 0 0 0 0 0 0 0 0 0 1 2 2 2 31 0 0 0 2 0 0 0 1 2 
12 2 2 2 2 2 2 2 29 29 29 29 29 29 29 29 50 12 12 12 12 51 9 9 9 9 9 9 2 2 2 2 2 2 2 12 12 12 12 12 78 78 78 12 78 78 78 12 12 
12 12 12 12 12 12 12 12 39 39 39 39 39 39 39 39 12 12 12 12 12 12 19 19 19 19 19 19 12 12 12 12 12 12 12 12 12 12 12 12 12 12 12 12 12 12 12 12 12 
12 12 12 12 12 12 12 12 39 39 39 39 39 39 39 39 12 12 12 12 12 12 19 19 19 19 19 19 12 12 12 12 12 12 12 12 12 12 12 12 12 12 12 12 12 12 12 12 12 
12 12 12 12 12 12 12 12 39 39 39 39 39 39 39 39 12 12 12 12 12 12 19 19 19 19 19 19 12 12 12 12 12 12 12 12 12 12 12 12 12 12 12 12 12 12 12 12 12 
12 12 12 12 12 12 12 12 39 39 39 39 39 39 39 39 12 12 12 12 12 12 19 19 19 19 19 19 22 22 22 22 22 22 22 12 12 12 12 12 12 12 12 12 12 12 12 12 
12 12 12 12 12 12 12 12 39 39 39 39 39 39 39 39 12 12 12 12 12 12 19 19 19 19 19 19 0 0 0 0 0 0 0 11 12 12 12 12 12 12 12 12 12 12 12 12 12 
12 12 12 12 12 12 12 12 39 39 39 39 39 39 39 39 12 12 12 12 12 12 19 19 19 19 19 19 0 0 0 0 0 0 0 11 12 12 12 12 12 12 12 12 12 12 12 12 12 
12 12 12 12 12 12 12 12 39 39 39 39 39 39 39 39 12 12 12 12 12 12 19 19 19 19 19 19 0 0 0 0 0 28 0 11 12 12 12 12 12 12 12 12 12 12 12 12 12 
12 12 12 12 12 12 12 12 12 12 12 12 12 12 12 12 12 12 12 12 12 12 12 12 12 12 12 12 2 2 2 2 2 2 2 41 12 12 12 12 12 12 12 12 12 12 12 12 12 
12 12 12 12 12 12 12 12 12 12 12 12 12 12 12 12 12 12 12 12 12 12 12 12 12 12 12 12 12 12 12 12 12 12 12 12 12 12 12 12 12 12 12 12 12 12 12 12 12 12 
12 12 12 12 12 12 12 12 12 12 12 12 12 12 12 12 12 12 12 12 12 12 12 12 12 12 12 12 12 12 12 12 12 12 12 12 12 12 12 12 12 12 12 12 12 12 12 12 12 12 
12 12 12 12 12 12 12 12 12 12 12 12 12 12 12 12 12 12 12 12 12 12 12 12 12 12 12 12 12 12 12 12 12 12 12 12 12 12 12 12 12 12 12 12 12 12 12 12 12 12 
12 12 12 12 12 12 12 12 12 12 12 12 12 12 12 12 12 12 12 12 12 12 12 12 12 12 12 12 12 12 12 12 12 12 12 12 12 12 12 12 12 12 12 12 12 12 12 12 12 12 
12 12 12 12 12 12 12 12 12 12 12 12 12 12 12 12 12 12 12 12 12 12 12 12 12 12 12 12 12 12 12 12 12 12 12 12 12 12 12 12 12 12 12 12 12 12 12 12 12 12 
12 12 12 12 12 12 12 12 12 12 12 12 12 12 12 12 12 12 12 12 12 12 12 12 12 12 12 12 12 12 12 12 12 12 12 12 12 12 12 12 12 12 12 12 12 12 12 12 12 12